---------PPPS---
---------P------
---------PPPP---
------------P---
--------EPPPP---
----------------
----------------
----------------
----------------
----------------
----------------
----------------
----------------
----------------
----------------
----------------
