----------------
-PPPP---PPP---S-
-P--PPP-P-PP--P-
-P----P-P--PPPP-
-P-PPPP-PP------
-P-P-----PP-----
-P-PPPP---PPPPP-
-P----P-------P-
-P---PP-------P-
-P--PP--PPP---P-
-P-PP---P-PPPPP-
-P-P----PP------
-P-PP----PPPPP--
-P--PPE------P--
-P-----------P--
-PPPPPPPPPPPPP--
