----------
-S--------
-P---EPPP-
PP------P-
P----PPPP-
PPPP-P----
---P-PPPP-
---P----P-
---PPPPPP-
----------
