--------
--------
--S-EP--
--P--P--
--P--P--
--PPPP--
--------
--------
